1111111111
1PCCCCCCC1
1PCCCCECC1
1111111111
