1111111111
1PCCCCCCC1
1E0000ECC1
1111111111
