1111111111111111111111111111111111111111111111111111111111111111111111111111111111111111111111111111
1000000000000000000000000000000000000000000000000000000000000000000000000000001111111111000000000001
100C000000000000000000000000000000000000000000000000000000000000000000000000001111111111000000000001
1P0C11E000000000000000000000000000000000000000000000000000000000000000000000001111111111000000000001
1000000000000000000000000000000000000000000000000000000000000000000000000000001111111111000000000001
1000000000000000000000000000000000000000000000000000000000000000000000000000001111111111000000000001
1000000000000000000000000000000000000000000000000000000000000000000000000000001111111111000000000001
1000000000000000000000000000000000000000000000000000000000000000000000000000001111111111000000000001
1000000000000000000000000000000000000000000000000000000000000000000000000000001111111111000000000001
1000000000000000000000000000000000000000000000000000000000000000000000000000001111111111000000000001
1000000000000000000000000000000000000000000000000000000000000000000000000000001111111111000000000001
1000000000000000000000000000000000000000000000000000000000000000000000000000001111111111000000000001
1000000000000000000000000000000000000000000000000000000000000000000000000000001111111111000000000001
1000000000000000000000000000000000000000000000000000000000000000000000000000001111111111000000000001
1000000000000000000000000000000000000000000000000000000000000000000000000000001111111111000000000001
1000000000000000000000000000000000000000000000000000000000000000000000000000001111111111000000000001
1000000000000000000000000000000000000000000000000000000000000000000000000000001111111111000000000001
1000000000000000000000000000000000000000000000000000000000000000000000000000001111111111000000000001
1000000000000000000000000000000000000000000000000000000000000000000000000000001111111111000000000001
1000000000000000000000000000000000000000000000000000000000000000000000000000001111111111000000000001
1000000000000000000000000000000000000000000000000000000000000000000000000000001111111111000000000001
1000000000000000000000000000000000000000000000000000000000000000000000000000001111111111000000000001
1000000000000000000000000000000000000000000000000000000000000000000000000000001111111111000000000001
1000000000000000000000000000000000000000000000000000000000000000000000000000001111111111000000000001
1000000000000000000000000000000000000000000000000000000000000000000000000000001111111111000000000001
1000000000000000000000000000000000000000000000000000000000000000000000000000001111111111000000000001
1000000000000000000000000000000000000000000000000000000000000000000000000000001111111111000000000001
1000000000000000000000000000000000000000000000000000000000000000000000000000001111111111000000000001
1000000000000000000000000000000000000000000000000000000000000000000000000000001111111111000000000001
1000000000000000000000000000000000000000000000000000000000000000000000000000001111111111000000000001
1000000000000000000000000000000000000000000000000000000000000000000000000000001111111111000000000001
1000000000000000000000000000000000000000000000000000000000000000000000000000001111111111000000000001
1000000000000000000000000000000000000000000000000000000000000000000000000000001111111111000000000001
1000000000000000000000000000000000000000000000000000000000000000000000000000001111111111000000000001
1000000000000000000000000000000000000000000000000000000000000000000000000000001111111111000000000001
1000000000000000000000000000000000000000000000000000000000000000000000000000001111111111000000000001
1000000000000000000000000000000000000000000000000000000000000000000000000000001111111111000000000001
1000000000000000000000000000000000000000000000000000000000000000000000000000001111111111000000000001
1000000000000000000000000000000000000000000000000000000000000000000000000000001111111111000000000001
1000000000000000000000000000000000000000000000000000000000000000000000000000001111111111000000000001
1000000000000000000000000000000000000000000000000000000000000000000000000000001111111111000000000001
1000000000000000000000000000000000000000000000000000000000000000000000000000001111111111000000000001
1000000000000000000000000000000000000000000000000000000000000000000000000000001111111111000000000001
1000000000000000000000000000000000000000000000000000000000000000000000000000001111111111000000000001
1000000000000000000000000000000000000000000000000000000000000000000000000000001111111111000000000001
1000000000000000000000000000000000000000000000000000000000000000000000000000001111111111000000000001
1000000000000000000000000000000000000000000000000000000000000000000000000000001111111111000000000001
1000000000000000000000000000000000000000000000000000000000000000000000000000001111111111000000000001
1000000000000000000000000000000000000000000000000000000000000000000000000000001111111111000000000001
1000000000000000000000000000000000000000000000000000000000000000000000000000001111111111000000000001
1000000000000000000000000000000000000000000000000000000000000000000000000000001111111111000000000001
1000000000000000000000000000000000000000000000000000000000000000000000000000001111111111000000000001
1000000000000000000000000000000000000000000000000000000000000000000000000000001111111111000000000001
1000000000000000000000000000000000000000000000000000000000000000000000000000001111111111000000000001
1000000000000000000000000000000000000000000000000000000000000000000000000000001111111111000000000001
1000000000000000000000000000000000000000000000000000000000000000000000000000001111111111000000000001
1000000000000000000000000000000000000000000000000000000000000000000000000000001111111111000000000001
1000000000000000000000000000000000000000000000000000000000000000000000000000001111111111000000000001
1000000000000000000000000000000000000000000000000000000000000000000000000000001111111111000000000001
1000000000000000000000000000000000000000000000000000000000000000000000000000001111111111000000000001
1000000000000000000000000000000000000000000000000000000000000000000000000000001111111111000000000001
1000000000000000000000000000000000000000000000000000000000000000000000000000001111111111000000000001
1000000000000000000000000000000000000000000000000000000000000000000000000000001111111111000000000001
1000000000000000000000000000000000000000000000000000000000000000000000000000001111111111000000000001
1000000000000000000000000000000000000000000000000000000000000000000000000000001111111111000000000001
1000000000000000000000000000000000000000000000000000000000000000000000000000001111111111000000000001
1000000000000000000000000000000000000000000000000000000000000000000000000000001111111111000000000001
1000000000000000000000000000000000000000000000000000000000000000000000000000001111111111000000000001
1000000000000000000000000000000000000000000000000000000000000000000000000000001111111111000000000001
1000000000000000000000000000000000000000000000000000000000000000000000000000001111111111000000000001
1000000000000000000000000000000000000000000000000000000000000000000000000000001111111111000000000001
1000000000000000000000000000000000000000000000000000000000000000000000000000001111111111000000000001
1000000000000000000000000000000000000000000000000000000000000000000000000000001111111111000000000001
1000000000000000000000000000000000000000000000000000000000000000000000000000001111111111000000000001
1000000000000000000000000000000000000000000000000000000000000000000000000000001111111111000000000001
1000000000000000000000000000000000000000000000000000000000000000000000000000001111111111000000000001
1000000000000000000000000000000000000000000000000000000000000000000000000000001111111111000000000001
1000000000000000000000000000000000000000000000000000000000000000000000000000001111111111000000000001
1000000000000000000000000000000000000000000000000000000000000000000000000000001111111111000000000001
1000000000000000000000000000000000000000000000000000000000000000000000000000001111111111000000000001
1000000000000000000000000000000000000000000000000000000000000000000000000000001111111111000000000001
1000000000000000000000000000000000000000000000000000000000000000000000000000001111111111000000000001
1000000000000000000000000000000000000000000000000000000000000000000000000000001111111111000000000001
1000000000000000000000000000000000000000000000000000000000000000000000000000001111111111000000000001
1000000000000000000000000000000000000000000000000000000000000000000000000000001111111111000000000001
1000000000000000000000000000000000000000000000000000000000000000000000000000001111111111000000000001
1000000000000000000000000000000000000000000000000000000000000000000000000000001111111111000000000001
1000000000000000000000000000000000000000000000000000000000000000000000000000001111111111000000000001
1000000000000000000000000000000000000000000000000000000000000000000000000000001111111111000000000001
1000000000000000000000000000000000000000000000000000000000000000000000000000001111111111000000000001
1000000000000000000000000000000000000000000000000000000000000000000000000000001111111111000000000001
1000000000000000000000000000000000000000000000000000000000000000000000000000001111111111000000000001
1000000000000000000000000000000000000000000000000000000000000000000000000000001111111111000000000001
1000000000000000000000000000000000000000000000000000000000000000000000000000001111111111000000000001
1000000000000000000000000000000000000000000000000000000000000000000000000000001111111111000000000001
1000000000000000000000000000000000000000000000000000000000000000000000000000001111111111000000000001
1000000000000000000000000000000000000000000000000000000000000000000000000000001111111111000000000001
1000000000000000000000000000000000000000000000000000000000000000000000000000001111111111000000000001
1000000000000000000000000000000000000000000000000000000000000000000000000000001111111111000000000001
1000000000000000000000000000000000000000000000000000000000000000000000000000001111111111000000000001
1000000000000000000000000000000000000000000000000000000000000000000000000000001111111111000000000001
1111111111111111111111111111111111111111111111111111111111111111111111111111111111111111111111111111
