1111111
1E00001
10000P1
1111111
