1111111111111
1C0100C0000C1
10000111110E1
11P1111111111
