1111111
1C00001
10000E1
1111111
