1111111
1C00001
10000P1
1111111
