1111111111111
100100000001
1000011111001
1P0011E001
1111111111111
