1111111111
1PCCCCCCC1
1CCCCCECC1
1111111111
