11111111111111111111111111111111111111111111111111111111111111111111111111111111111111111111111111111
10000000000000000000000000000000000000000000000000000000000000000000000000000011111111110000000000001
100C0000000000000000000000000000000000000000000000000000000000000000000000000011111111110000000000001
1P0C11E0000000000000000000000000000000000000000000000000000000000000000000000011111111110000000000001
10000000000000000000000000000000000000000000000000000000000000000000000000000011111111110000000000001
10000000000000000000000000000000000000000000000000000000000000000000000000000011111111110000000000001
10000000000000000000000000000000000000000000000000000000000000000000000000000011111111110000000000001
10000000000000000000000000000000000000000000000000000000000000000000000000000011111111110000000000001
10000000000000000000000000000000000000000000000000000000000000000000000000000011111111110000000000001
10000000000000000000000000000000000000000000000000000000000000000000000000000011111111110000000000001
10000000000000000000000000000000000000000000000000000000000000000000000000000011111111110000000000001
10000000000000000000000000000000000000000000000000000000000000000000000000000011111111110000000000001
10000000000000000000000000000000000000000000000000000000000000000000000000000011111111110000000000001
10000000000000000000000000000000000000000000000000000000000000000000000000000011111111110000000000001
10000000000000000000000000000000000000000000000000000000000000000000000000000011111111110000000000001
10000000000000000000000000000000000000000000000000000000000000000000000000000011111111110000000000001
10000000000000000000000000000000000000000000000000000000000000000000000000000011111111110000000000001
10000000000000000000000000000000000000000000000000000000000000000000000000000011111111110000000000001
10000000000000000000000000000000000000000000000000000000000000000000000000000011111111110000000000001
10000000000000000000000000000000000000000000000000000000000000000000000000000011111111110000000000001
10000000000000000000000000000000000000000000000000000000000000000000000000000011111111110000000000001
10000000000000000000000000000000000000000000000000000000000000000000000000000011111111110000000000001
10000000000000000000000000000000000000000000000000000000000000000000000000000011111111110000000000001
10000000000000000000000000000000000000000000000000000000000000000000000000000011111111110000000000001
10000000000000000000000000000000000000000000000000000000000000000000000000000011111111110000000000001
10000000000000000000000000000000000000000000000000000000000000000000000000000011111111110000000000001
10000000000000000000000000000000000000000000000000000000000000000000000000000011111111110000000000001
10000000000000000000000000000000000000000000000000000000000000000000000000000011111111110000000000001
10000000000000000000000000000000000000000000000000000000000000000000000000000011111111110000000000001
10000000000000000000000000000000000000000000000000000000000000000000000000000011111111110000000000001
10000000000000000000000000000000000000000000000000000000000000000000000000000011111111110000000000001
10000000000000000000000000000000000000000000000000000000000000000000000000000011111111110000000000001
10000000000000000000000000000000000000000000000000000000000000000000000000000011111111110000000000001
10000000000000000000000000000000000000000000000000000000000000000000000000000011111111110000000000001
10000000000000000000000000000000000000000000000000000000000000000000000000000011111111110000000000001
10000000000000000000000000000000000000000000000000000000000000000000000000000011111111110000000000001
10000000000000000000000000000000000000000000000000000000000000000000000000000011111111110000000000001
10000000000000000000000000000000000000000000000000000000000000000000000000000011111111110000000000001
10000000000000000000000000000000000000000000000000000000000000000000000000000011111111110000000000001
10000000000000000000000000000000000000000000000000000000000000000000000000000011111111110000000000001
10000000000000000000000000000000000000000000000000000000000000000000000000000011111111110000000000001
10000000000000000000000000000000000000000000000000000000000000000000000000000011111111110000000000001
10000000000000000000000000000000000000000000000000000000000000000000000000000011111111110000000000001
10000000000000000000000000000000000000000000000000000000000000000000000000000011111111110000000000001
10000000000000000000000000000000000000000000000000000000000000000000000000000011111111110000000000001
10000000000000000000000000000000000000000000000000000000000000000000000000000011111111110000000000001
10000000000000000000000000000000000000000000000000000000000000000000000000000011111111110000000000001
10000000000000000000000000000000000000000000000000000000000000000000000000000011111111110000000000001
10000000000000000000000000000000000000000000000000000000000000000000000000000011111111110000000000001
10000000000000000000000000000000000000000000000000000000000000000000000000000011111111110000000000001
10000000000000000000000000000000000000000000000000000000000000000000000000000011111111110000000000001
10000000000000000000000000000000000000000000000000000000000000000000000000000011111111110000000000001
10000000000000000000000000000000000000000000000000000000000000000000000000000011111111110000000000001
10000000000000000000000000000000000000000000000000000000000000000000000000000011111111110000000000001
10000000000000000000000000000000000000000000000000000000000000000000000000000011111111110000000000001
10000000000000000000000000000000000000000000000000000000000000000000000000000011111111110000000000001
10000000000000000000000000000000000000000000000000000000000000000000000000000011111111110000000000001
10000000000000000000000000000000000000000000000000000000000000000000000000000011111111110000000000001
10000000000000000000000000000000000000000000000000000000000000000000000000000011111111110000000000001
10000000000000000000000000000000000000000000000000000000000000000000000000000011111111110000000000001
10000000000000000000000000000000000000000000000000000000000000000000000000000011111111110000000000001
10000000000000000000000000000000000000000000000000000000000000000000000000000011111111110000000000001
10000000000000000000000000000000000000000000000000000000000000000000000000000011111111110000000000001
10000000000000000000000000000000000000000000000000000000000000000000000000000011111111110000000000001
10000000000000000000000000000000000000000000000000000000000000000000000000000011111111110000000000001
10000000000000000000000000000000000000000000000000000000000000000000000000000011111111110000000000001
10000000000000000000000000000000000000000000000000000000000000000000000000000011111111110000000000001
10000000000000000000000000000000000000000000000000000000000000000000000000000011111111110000000000001
10000000000000000000000000000000000000000000000000000000000000000000000000000011111111110000000000001
10000000000000000000000000000000000000000000000000000000000000000000000000000011111111110000000000001
10000000000000000000000000000000000000000000000000000000000000000000000000000011111111110000000000001
10000000000000000000000000000000000000000000000000000000000000000000000000000011111111110000000000001
10000000000000000000000000000000000000000000000000000000000000000000000000000011111111110000000000001
10000000000000000000000000000000000000000000000000000000000000000000000000000011111111110000000000001
10000000000000000000000000000000000000000000000000000000000000000000000000000011111111110000000000001
10000000000000000000000000000000000000000000000000000000000000000000000000000011111111110000000000001
10000000000000000000000000000000000000000000000000000000000000000000000000000011111111110000000000001
10000000000000000000000000000000000000000000000000000000000000000000000000000011111111110000000000001
10000000000000000000000000000000000000000000000000000000000000000000000000000011111111110000000000001
10000000000000000000000000000000000000000000000000000000000000000000000000000011111111110000000000001
10000000000000000000000000000000000000000000000000000000000000000000000000000011111111110000000000001
10000000000000000000000000000000000000000000000000000000000000000000000000000011111111110000000000001
10000000000000000000000000000000000000000000000000000000000000000000000000000011111111110000000000001
10000000000000000000000000000000000000000000000000000000000000000000000000000011111111110000000000001
10000000000000000000000000000000000000000000000000000000000000000000000000000011111111110000000000001
10000000000000000000000000000000000000000000000000000000000000000000000000000011111111110000000000001
10000000000000000000000000000000000000000000000000000000000000000000000000000011111111110000000000001
10000000000000000000000000000000000000000000000000000000000000000000000000000011111111110000000000001
10000000000000000000000000000000000000000000000000000000000000000000000000000011111111110000000000001
10000000000000000000000000000000000000000000000000000000000000000000000000000011111111110000000000001
10000000000000000000000000000000000000000000000000000000000000000000000000000011111111110000000000001
10000000000000000000000000000000000000000000000000000000000000000000000000000011111111110000000000001
10000000000000000000000000000000000000000000000000000000000000000000000000000011111111110000000000001
10000000000000000000000000000000000000000000000000000000000000000000000000000011111111110000000000001
10000000000000000000000000000000000000000000000000000000000000000000000000000011111111110000000000001
10000000000000000000000000000000000000000000000000000000000000000000000000000011111111110000000000001
10000000000000000000000000000000000000000000000000000000000000000000000000000011111111110000000000001
10000000000000000000000000000000000000000000000000000000000000000000000000000011111111110000000000001
10000000000000000000000000000000000000000000000000000000000000000000000000000011111111110000000000001
11111111111111111111111111111111111111111111111111111111111111111111111111111111111111111111111111111
