1111111
1C00001
10P00E1
1110011
