1111111
1P00011
10001E1
1111111
