11111111111
1P000000001
10001000101
1C01C1001E1
11111111111
