111111
1P0001
101101
101E01
111111
