111111
1P0001
1011C1
101EC1
111111
