1111111111111
10000000000C1
1001011111001
1P1C11E000001
1111111111111
